{{0},
{0},
{0},
{0},
{0},
{0},
{0},
{0},
{0},
{0},
{1,1,1,1,3,3,3,3,3,5,5,5,7,7,7,7,7,9,7,11,11,11,11,11,13,15,15,11,11,11,11,11,11,11,15,15,15,15,1,1,1,0},
{1,1,3,3,3,3,3,3,3,3,5,5,5,5,7,5,7,7,9,7,9,9,13,15,9,13,13,15,15,15,15,15,13,13,13,13,13,15,13,13,15,0},
{1,1,3,3,3,3,3,3,3,3,3,5,7,7,7,7,11,7,9,11,11,15,13,15,15,15,15,15,15,15,15,13,15,13,9,1,13,1,1,1,1,0},
{1,3,3,3,3,3,3,3,5,7,7,5,7,7,5,7,7,13,7,15,15,15,15,9,13,11,15,11,13,11,11,15,15,11,9,9,11,1,1,1,1,0},
{1,1,3,3,3,3,3,5,5,5,5,7,7,7,9,7,11,7,9,13,9,15,15,11,13,11,15,11,11,11,13,11,15,13,11,9,1,1,1,15,15,0},
{1,1,3,3,3,3,3,3,3,5,7,5,5,7,7,5,7,13,11,11,9,9,11,13,13,13,13,13,15,15,11,15,13,15,7,15,11,11,1,11,1,0},
{1,1,3,3,3,3,3,5,3,5,5,5,5,5,7,7,7,7,9,11,15,11,15,13,15,15,15,15,15,13,13,11,9,11,13,15,13,1,1,1,1,0},
{1,3,3,3,3,3,3,3,3,5,5,5,5,5,7,7,9,7,11,11,11,11,11,13,13,13,13,11,15,13,13,11,13,13,13,13,13,13,1,1,1,0},
{1,1,3,3,3,3,3,3,3,5,5,5,5,5,7,7,7,7,7,15,15,11,15,15,15,15,13,15,15,13,13,15,15,1,1,1,1,1,1,1,1,0},
{1,1,3,3,3,3,3,3,5,5,3,3,7,7,7,7,7,7,13,15,13,15,11,15,13,15,13,15,13,15,11,15,15,15,13,15,13,1,1,1,1,0},
{1,1,3,3,3,3,3,3,5,5,5,7,7,7,9,11,11,13,15,15,13,13,15,13,13,13,11,11,15,13,11,13,13,15,13,13,13,1,1,1,1,0},
{1,1,3,3,3,3,3,5,5,5,5,5,7,11,7,11,9,15,9,9,15,13,15,11,15,15,15,13,13,15,15,13,11,15,13,1,1,1,1,1,1,0},
{1,3,3,3,3,3,3,3,5,5,5,5,5,5,7,11,11,15,13,15,11,13,15,15,13,11,15,11,15,15,15,13,11,15,13,1,1,1,1,1,1,0},
{1,1,3,3,3,3,3,3,3,5,5,5,7,7,7,9,7,7,13,15,9,15,15,13,11,13,13,15,15,15,11,15,13,9,1,1,1,1,1,1,1,0},
{1,1,3,3,3,3,3,3,3,5,5,5,5,7,9,11,7,11,11,11,11,11,15,13,11,15,15,15,13,15,13,9,13,15,13,1,1,1,1,1,1,0},
{1,3,3,3,3,3,5,5,5,5,5,5,5,9,7,9,5,13,13,15,9,13,11,15,15,15,15,15,11,13,13,13,15,15,15,13,13,1,1,1,1,0},
{1,1,3,3,3,3,3,3,3,5,5,5,7,9,7,9,7,13,15,15,11,11,13,15,13,15,15,13,15,13,11,15,13,15,13,11,1,1,1,1,1,0},
{1,1,3,3,3,3,5,5,5,5,5,5,5,7,7,7,9,9,13,11,9,13,13,9,13,11,15,11,11,13,15,11,9,1,1,15,1,1,1,1,1,0},
{1,1,1,3,3,3,3,3,5,5,5,7,5,5,7,9,13,7,15,15,11,11,13,15,11,13,15,11,13,13,15,11,11,9,15,15,1,1,1,1,1,0},
{1,1,3,3,3,3,3,3,3,5,5,5,5,5,7,7,11,11,7,11,15,15,15,15,11,13,15,15,15,11,15,9,15,11,13,1,15,1,1,1,1,0},
{1,1,3,3,3,3,5,5,5,5,5,7,7,7,9,9,9,13,11,11,13,13,15,15,15,13,15,13,15,15,15,13,13,9,11,1,1,1,13,1,1,0},
{1,1,1,3,3,3,5,5,5,5,5,5,5,9,7,9,11,7,7,15,11,13,9,13,13,11,13,11,13,9,11,11,13,11,15,1,1,1,1,1,1,0},
{1,3,3,3,3,3,3,3,5,5,5,5,5,9,9,9,9,15,13,11,13,13,11,13,13,13,15,15,13,13,15,13,1,1,1,1,1,1,1,1,1,0},
{1,3,3,3,3,3,3,5,5,5,7,7,7,7,7,9,13,7,15,15,15,13,13,15,13,13,15,15,13,15,15,15,1,1,1,1,1,1,1,1,1,0},
{1,1,3,3,3,3,3,3,3,3,5,7,5,7,9,9,7,9,11,11,13,15,15,13,15,13,15,13,13,15,13,15,1,1,1,1,1,1,1,1,1,0},
{1,3,3,3,3,3,3,5,5,5,5,5,9,9,9,11,9,11,13,11,15,15,15,15,13,13,13,15,15,11,11,1,1,1,1,1,1,1,1,1,1,0},
{1,3,3,3,3,3,3,3,5,3,5,5,9,9,9,11,7,11,13,13,13,11,13,11,11,15,15,13,13,13,1,1,1,1,1,1,1,1,1,1,1,0},
{1,3,3,3,3,3,3,3,5,5,5,5,7,7,11,7,11,13,11,11,15,15,13,13,15,15,15,13,13,13,13,1,1,1,1,1,1,1,1,1,1,0},
{1,3,3,3,3,3,3,3,5,5,5,7,7,5,7,5,15,15,11,15,15,15,11,13,15,15,15,15,13,15,11,13,1,1,1,1,1,1,1,1,1,0},
{1,3,3,3,3,3,3,3,5,3,5,7,5,5,9,7,13,11,15,15,13,15,15,13,13,13,13,13,13,13,15,13,15,1,1,1,1,1,1,1,1,0},
{1,1,3,3,3,3,3,5,5,5,5,7,9,7,9,7,11,11,13,13,15,11,13,15,15,13,13,15,15,13,13,15,1,13,1,1,1,1,1,1,1,0},
{1,3,3,3,3,3,3,5,5,5,5,5,9,7,9,7,9,15,13,15,13,13,15,15,13,13,15,13,13,13,13,13,1,1,1,1,1,1,1,1,1,0},
{1,3,3,3,3,3,3,3,5,3,5,5,9,7,9,9,11,11,13,11,15,15,11,15,13,15,15,15,15,15,15,11,1,1,1,1,1,1,1,1,1,0},
{1,3,3,3,3,3,3,3,3,5,5,5,7,9,9,7,9,11,11,11,11,11,13,15,13,13,15,13,11,15,13,13,1,1,1,1,1,1,1,1,1,0},
{1,3,3,3,3,3,3,3,5,5,5,5,5,5,7,9,15,15,11,15,13,15,15,15,15,13,13,15,15,13,1,1,1,1,1,1,1,1,1,1,1,0},
{1,3,3,3,3,3,3,5,5,5,7,7,7,9,9,9,9,9,9,15,11,13,13,15,13,15,15,15,15,11,15,15,1,1,1,1,1,1,1,1,1,0},
{1,1,3,3,3,3,3,7,5,7,5,7,7,9,7,11,11,11,13,11,13,13,15,15,15,15,13,15,15,15,13,1,1,1,1,1,1,1,1,1,1,0},
{1,3,3,3,3,3,5,5,5,5,5,7,7,7,13,9,9,11,7,9,13,9,13,13,13,13,13,15,15,15,15,1,1,1,1,1,1,1,1,1,1,0},
{1,3,3,3,3,3,3,3,5,5,5,5,7,9,9,9,9,9,15,13,13,11,13,15,13,15,15,15,15,11,11,11,1,1,1,1,1,1,1,1,1,0},
{1,3,3,3,3,3,3,3,5,5,5,7,5,5,7,11,15,11,9,11,9,13,15,11,11,13,13,13,13,13,15,15,1,1,1,1,1,1,1,1,1,0},
{1,3,3,3,3,3,3,3,5,7,7,9,7,9,5,9,13,15,11,15,13,15,15,15,11,15,13,13,15,13,13,15,1,1,1,1,1,1,1,1,1,0},
{1,3,3,3,3,3,3,5,5,5,5,7,5,9,9,13,11,15,13,13,15,13,15,15,13,15,15,13,13,15,15,1,1,1,1,1,1,1,1,1,1,0},
{1,3,3,3,3,3,3,3,5,5,5,5,5,7,7,7,13,13,15,15,15,11,15,13,15,15,13,13,15,15,15,1,9,1,1,1,1,1,1,1,1,0},
{1,3,3,3,3,3,3,3,3,5,5,5,5,5,9,7,11,11,11,15,13,13,11,15,13,11,15,13,13,15,1,15,1,1,1,1,1,1,1,1,1,0},
{1,1,3,3,3,3,3,3,5,5,5,7,7,7,11,13,11,11,13,13,13,13,11,15,15,13,11,15,15,15,15,15,1,1,1,1,1,1,1,1,1,0},
{1,3,3,3,3,3,3,3,5,5,5,5,5,9,9,11,13,9,11,9,13,15,13,15,13,13,13,15,11,13,15,1,1,1,1,1,1,1,1,1,1,0},
{1,3,3,3,3,3,5,3,7,5,5,9,7,11,11,11,11,13,13,13,13,13,13,15,15,13,13,15,15,13,1,1,1,1,1,1,1,1,1,1,1,0},
{1,1,3,3,3,3,3,3,3,5,5,7,7,7,13,9,13,7,13,7,9,15,13,15,15,15,13,15,11,11,15,1,1,1,1,1,1,1,1,1,1,0},
{1,3,3,3,3,5,5,5,5,5,5,7,5,7,7,11,7,11,11,11,13,15,15,15,15,15,15,15,15,15,1,1,1,1,1,1,1,1,1,1,1,0},
{1,3,3,3,3,3,3,3,5,5,5,5,9,5,11,13,11,11,11,13,15,11,11,15,13,15,15,15,13,15,15,1,1,1,1,1,1,1,1,1,1,0},
{1,3,3,3,3,3,3,3,5,5,5,7,9,9,13,9,9,7,13,13,11,9,15,15,15,15,15,13,13,13,13,1,1,1,1,1,1,1,1,1,1,0},
{1,3,3,3,3,3,3,5,5,5,7,5,9,7,9,11,13,13,9,13,13,15,13,15,11,15,15,15,15,15,15,1,1,1,1,1,1,1,1,1,1,0},
{1,1,3,3,3,3,3,3,5,5,5,5,7,9,9,11,9,9,11,15,13,15,13,15,15,15,15,15,15,11,15,13,1,1,1,1,1,1,1,1,1,0},
{1,1,3,3,3,3,3,3,5,5,5,5,7,7,9,11,9,9,11,11,13,15,15,15,15,15,15,15,15,15,13,1,1,1,1,1,1,1,1,1,1,0},
{1,3,3,3,3,3,3,3,5,5,5,5,9,5,9,7,13,15,13,15,13,15,13,13,15,15,15,13,15,13,13,15,1,1,1,1,1,1,1,1,1,0},
{1,3,3,3,3,3,5,5,5,5,5,5,7,7,7,11,15,15,15,15,13,15,15,15,15,15,15,15,11,15,15,1,1,1,1,1,1,1,1,1,1,0},
{1,3,3,3,3,3,3,5,5,5,5,5,5,9,7,9,11,7,15,15,11,13,15,15,13,15,15,13,9,15,15,15,1,1,1,1,1,1,1,1,1,0},
{1,1,3,3,3,3,5,5,7,7,7,7,7,7,9,11,9,13,11,11,11,15,15,13,15,15,9,13,11,15,15,1,1,1,1,1,1,1,1,1,1,0},
{1,3,3,3,3,3,3,5,5,5,5,5,9,7,5,11,13,13,13,9,15,13,13,15,15,13,13,15,13,13,1,1,1,1,1,1,1,1,1,1,1,0},
{1,3,3,3,3,3,3,5,5,5,7,5,7,7,7,13,9,15,15,13,13,15,11,11,13,13,15,13,13,9,13,1,1,1,1,1,1,1,1,1,1,0},
{1,3,3,3,3,3,3,5,5,5,5,7,5,7,7,11,11,13,13,15,15,15,15,13,13,15,15,15,15,15,1,1,1,1,1,1,1,1,1,1,1,0},
{1,3,3,3,3,3,3,3,5,5,5,7,5,9,5,11,13,13,15,15,11,13,13,15,15,15,15,15,15,15,1,1,1,1,1,1,1,1,1,1,1,0},
{1,3,3,3,3,3,5,5,5,5,5,7,7,7,7,13,13,13,15,13,13,15,15,13,11,15,13,15,15,15,1,1,1,1,1,1,1,1,1,1,1,0},
{1,3,3,3,3,3,3,3,5,5,7,7,9,7,9,13,13,11,11,13,13,13,13,13,13,15,11,15,13,13,15,1,1,1,1,1,1,1,1,1,1,0},
{1,1,3,3,3,3,3,3,5,7,5,5,7,11,7,11,9,15,13,13,13,9,13,13,13,15,15,15,15,15,15,15,1,1,1,1,1,1,1,1,1,0},
{1,1,3,3,3,3,3,5,5,5,7,7,7,9,9,11,11,9,15,15,15,15,13,15,13,15,13,13,13,13,15,13,1,1,1,1,1,1,1,1,1,0},
{1,3,3,3,3,3,3,3,5,5,5,5,7,7,7,7,7,13,13,13,15,13,15,15,15,13,13,15,15,15,13,1,1,1,1,1,1,1,1,1,1,0},
{1,3,3,3,3,3,3,3,5,5,5,5,5,7,7,7,13,13,9,13,11,13,15,15,15,13,15,13,15,15,15,1,1,1,1,1,1,1,1,1,1,0},
{1,1,3,3,3,3,3,3,5,5,5,5,5,7,11,9,11,9,9,15,15,15,15,13,15,15,13,15,15,15,15,1,1,1,1,1,1,1,1,1,1,0},
{1,3,3,3,3,3,3,3,3,3,7,7,7,9,7,13,11,7,7,13,15,15,15,15,15,13,13,13,15,15,11,15,1,1,1,1,1,1,1,1,1,0},
{1,3,3,3,3,3,5,5,5,7,7,7,9,9,13,11,13,13,13,13,13,11,11,11,11,15,13,15,13,15,15,9,1,1,1,1,1,1,1,1,1,0},
{1,1,3,3,3,3,3,3,5,5,5,5,7,9,11,11,11,15,9,11,13,13,11,11,13,15,15,15,15,15,13,1,1,1,1,1,1,1,1,1,1,0},
{1,3,3,3,3,3,3,3,5,5,7,5,7,7,7,7,7,13,13,15,13,15,15,13,15,15,13,13,15,11,11,1,1,1,1,1,1,1,1,1,1,0},
{1,3,3,3,3,5,3,5,5,5,5,9,5,9,11,7,15,9,11,15,11,15,15,11,13,13,15,13,15,13,13,1,1,1,1,1,1,1,1,1,1,0},
{1,3,3,3,3,3,3,5,5,5,7,7,7,7,7,11,11,11,15,13,13,13,11,15,13,15,15,15,15,15,15,13,1,1,1,1,1,1,1,1,1,0},
{1,3,3,3,3,3,5,5,5,5,5,5,7,7,9,9,13,13,13,13,15,15,13,15,13,11,15,15,15,15,9,1,1,1,1,1,1,1,1,1,1,0},
{1,1,3,3,3,3,5,5,5,5,7,7,9,5,7,9,7,15,7,15,11,15,15,15,15,15,15,15,15,15,15,1,1,1,1,1,1,1,1,1,1,0},
{1,3,3,3,3,3,3,5,3,5,7,7,9,9,15,7,11,11,15,15,15,13,15,15,11,15,13,13,15,13,1,1,1,1,1,1,1,1,1,1,1,0},
{1,3,3,3,3,3,5,5,5,5,5,7,5,9,7,13,9,9,13,13,13,13,15,15,13,15,13,15,15,13,15,13,1,1,1,1,1,1,1,1,1,0},
{1,3,3,3,3,3,3,5,5,7,7,7,7,7,7,7,11,11,13,13,13,13,13,13,15,15,15,15,15,15,13,15,1,1,1,1,1,1,1,1,1,0},
{1,3,3,3,3,3,3,5,5,5,5,7,7,7,7,7,13,13,13,15,13,15,15,15,13,15,15,15,13,15,1,1,1,1,1,1,1,1,1,1,1,0},
{1,3,3,3,3,3,3,3,5,5,5,5,7,7,9,9,11,11,9,11,15,13,13,13,13,13,13,13,13,15,9,1,1,1,1,1,1,1,1,1,1,0},
{1,3,3,3,5,5,5,5,5,5,5,5,7,7,7,11,11,11,15,13,15,15,15,15,15,13,15,15,15,13,15,15,15,1,1,1,1,1,1,1,1,0},
{1,3,3,3,3,3,3,3,5,5,5,7,5,7,5,9,11,9,11,15,13,15,15,13,15,15,15,15,15,15,1,1,1,1,1,1,1,1,1,1,1,0},
{1,3,3,3,3,3,3,5,5,7,5,5,5,7,9,11,11,11,15,15,15,15,15,15,15,15,15,15,15,15,15,15,1,1,1,1,1,1,1,1,1,0},
{1,3,3,3,3,5,5,5,5,5,5,5,5,11,9,9,11,13,15,11,15,15,13,13,13,13,13,13,15,13,15,15,1,1,1,1,1,1,1,1,1,0},
{1,3,3,3,3,3,5,5,5,5,5,5,7,9,9,7,7,13,7,11,13,13,13,13,13,13,13,15,15,13,15,13,1,1,1,1,1,1,1,1,1,0},
{1,3,3,3,3,3,3,5,7,7,5,7,9,7,7,11,7,9,9,15,9,15,11,15,15,15,15,15,13,13,13,1,1,1,1,1,1,1,1,1,1,0},
{1,3,3,3,3,3,5,5,5,5,5,5,7,7,7,13,9,15,13,15,15,15,13,15,13,15,15,15,13,15,11,15,1,1,1,1,1,1,1,1,1,0},
{1,3,3,3,3,3,3,3,5,5,5,7,7,11,9,11,11,13,13,11,13,15,15,13,13,15,15,13,13,15,13,1,1,1,1,1,1,1,1,1,1,0},
{1,3,3,3,3,3,5,5,5,5,7,7,9,9,9,11,9,13,11,13,11,13,13,15,15,13,11,13,15,15,15,13,1,1,1,1,1,1,1,1,1,0},
{0}}